##############################################
G  #              #        #           #     #
#  #  #  ##########  ####  #  #######  #  ####
#     #  #        #  #     #        #  #     #
#######  #  ####  #  #  ##########  #  ####  #
#        #     #     #  #           #     #  #
#  ##########  #######  #  ##########  #  #  #
#        #  #  #        #  #        #  #  #  #
#  ####  #  #  #  #######  #  ####  ####  #  #
#     #  #  #  #     #     #     #        #  #
####  #  #  #  ####  #  #######  ##########  #
#     #  #  #  #     #        #     #        #
#  ####  #  #  ################  #  #  #######
#  #  #  #  #     #  #           #  #  #     #
#  #  #  #  ####  #  #  ####  ####  #  ####  #
#     #  #  #  #  #     #  #  #     #     #  #
#  ####  #  #  #  ####  #  #  ####  ####  #  #
#  #     #     #        #     #           #  #
####  #######  ################  #  #######  #
#           #                    #        #  #
#  #  ####  ####  ####  ##########  ####  #  #
#  #  #  #  #     #     #     #  #  #        #
#  #  #  #  #  ####  #######  #  #  #######  #
#  #     #  #  #  #  #     #  #     #     #  #
#  #######  #  #  #  #  #  #  #######  ####  #
#  #     #     #     #  #  #     #     #     #
#  #  #  ####  #######  #  ####  #  ####  #  #
#  #  #     #     #     #     #  #        #  #
#  #  ####  ####  ####  #  ####  ##########  #
#     #        #        #        #           S
##############################################